11111111111111111111111111
1E00000000000100000000C111
100010011000000100101111K1
100011100000P01001100011C1
1C100000000011111110000001
11111111111111111111111111