11111111111111111111
10C110000000C00111K1
101111001111110000C1
1000000111C100P11001
10111111000100111001
10C110000E0000C1C001
11111111111111111111