11111111111111111111111111111111
1P00000000001T000000000001C000E1
100011101000011001C1011100000001
10000000110000000001000011101001
1011100000010111C000000000100001
100000111000000010111000000011C1
1C00100001T000000000011100010001
100010000001C1110000000000100001
10000C11100000001T000001C000K001
11111111111111111111111111111111
