11111111111111111111111111111111
1PK0000100000C0001000000000010E1
10001110100011100001111000001001
1000000T100000000000001011101001
1011100000010111TT00000000100001
100000111000000010111000000011C1
1C0010000100000000000111000100T1
1000100000010111T000000000100001
10000011100000001C1C1CC1000000C1
11111111111111111111111111111111