11111111111111111111
1C1T0C10001000C000E1
101010001010111T1101
1C0011101C000010C001
11101T00101010101011
10C01101100000001001
101000C0110111011101
1011011000010000C001
100C00110111C11011T1
101110100C000100C101
100P10001101110111C1
1K000C001T0000C00001
11111111111111111111