


111111111111111
111111111111111
111000000000111
111111111111111