11111111111111
100000000000P1
1C1C1C1C100001
10000000000
11111111111111