11111111111111111111111
1K0000000000P1110111111
1C1C1C1C100001110111111
1000000000011110C0111E1
11111111111111111111111