1110000011111
1000001E00001
1C1C0000000P1
1111111111111